01040000000000000000
11110111111111000300
00003000000001003000
04030000100201000000
00000011111111000000
04010000100040001000
00010000100004001000
00010000111111110000
00010000100000001000
00011100103001001000
11000100103011101000
00000000003000001000
00011111111111111010
00000000000000000000
00000000000000000404
